beneficial	harmful
honest	dishonest
progressive	regressive
transparent	opaque
constructive	destructive
informed	uninformed
ethical	unethical
authentic	inauthentic
tolerant	intolerant
responsible	irresponsible
rational	irrational
objective	subjective
legitimate	illegitimate
inclusive	exclusive
productive	unproductive
professional	unprofessional
realistic	unrealistic
consistent	inconsistent
relevant	irrelevant
sophisticated	unsophisticated